map 10 10;
BEGIN_MAPDATA,
2,2,2,2,2,2,2,2,2,2,
0,0,0,0,0,0,0,0,0,0,
0,0,0,0,0,0,0,0,0,0,
3,3,0,0,0,0,0,0,0,0,
3,0,0,0,0,2,5,0,0,5,
0,0,0,0,0,0,0,0,0,5,
0,0,5,0,0,0,0,0,0,6,
0,0,0,0,4,0,0,0,0,6,
0,0,0,0,0,1,0,0,0,6,
2,4,4,4,0,0,0,0,0,2,
END_MAPDATA;
