map 10 10;
BEGIN_MAPDATA,
2,2,2,2,2,2,2,2,2,2,
0,0,0,0,0,0,0,0,0,0,
0,0,0,0,0,0,0,0,0,0,
0,0,0,0,0,0,0,0,0,0,
0,0,0,0,0,2,0,0,0,0,
0,0,0,0,0,0,0,0,0,0,
0,0,0,0,0,0,0,0,0,0,
0,0,0,0,0,0,0,0,0,0,
0,0,0,0,0,1,0,0,0,0,
2,0,0,0,0,0,0,0,0,2,
END_MAPDATA;
